..................#######................................
..................#.....#................................
..................#.....#................................
..................#.....#................................
..................#.....#................................
..................#.....#................................
..................#.....#................................
..................#.....#................................
..................##########^...................#########
........................#.......................#.......#
........................#############...........#.......#
....................................#...........#.......#
....................................#...........#.......#
....................................#...........#.......#
....................................#.........###########
....................................#.........#.#........
....................................#.........#.#........
....................................#.........#.#........
....................................#############........
..............................................#..........
..............................................#..........
..............................................#..........
..............................................#..........
..............................................#..........
..............................................#..........
..............................................#..........
......................................#########..........
......................................#..................
......................................#..................
......................................#..................
......................................#..................
......................................#..................
......................................#..................
......................................#..................
..........#########...................#..................
..........#.......#...................#..................
..........#.......#...................#..................
..........#.......#...................#..................
..........#.......#...................###########........
..........#.......#.............................#........
........#############.#.........................#........
........#.#.......#.#.#.........................#........
........#.#.......###########...................#........
........#.#.........#.#.....#...................#........
###########.........#.#.....#...................#........
#.......#...........#.#.....#...................#........
#.......#...........#.#.....#...........#########........
#.......#...........#.#.....#...........#................
#.......#...........#############.......#................
#.......#.............#.....#...#.......#................
#########.............#######...#.......#................
................................#.......#................
................................#.......#................
................................#.......#................
................................#.......#................
................................#.......#................
................................#########................
